Viewer:( 375 , 85 ) FOV: 66 ,viewAngle: 205 looking: 240 DPP: 476 
red: -10 green: -10 blue: -10 trigger_everytime_on_square? 1 Height: 32 width: 32
0{ 1 1 29 29 1 2 3 0 0 0 1 }{ 1 27 10 26 26 2 3 0 0 0 1 }{ 1 27 27 26 26 2 3 0 0 0 1 }{ 1 27 10 26 26 2 3 0 0 0 1 }{ 1 27 27 26 26 2 3 0 0 0 1 }{ 1 27 27 26 26 2 3 0 0 0 1 }{ 1 27 27 26 26 2 3 0 0 0 1 }{ 1 27 27 26 26 2 3 0 0 0 1 }{ 1 27 27 26 26 2 3 0 0 0 1 }{ 1 1 1 1 1 2 3 0 0 0 1 }{ 1 1 1 1 1 2 3 0 0 0 1 }{ 1 1 1 1 1 2 3 0 0 0 1 }{ 1 1 1 1 1 2 3 0 0 0 1 }{ 1 1 1 1 1 2 3 0 0 0 1 }{ 1 1 1 1 1 2 3 0 0 0 1 }{ 1 1 1 1 1 2 3 0 0 0 1 }{ 1 1 1 1 1 2 3 0 0 0 1 }{ 1 1 1 1 1 2 3 0 0 0 1 }{ 1 1 1 1 1 2 3 0 0 0 1 }{ 1 1 1 1 1 2 3 0 0 0 1 }{ 1 1 1 1 1 2 3 0 0 0 1 }{ 1 1 1 1 1 2 3 0 0 0 1 }{ 1 1 1 1 1 2 3 0 0 0 1 }{ 1 1 1 1 1 2 3 0 0 0 1 }{ 1 1 1 1 1 2 3 0 0 0 1 }{ 1 1 1 1 1 2 3 0 0 0 1 }{ 1 1 1 1 1 2 3 0 0 0 1 }{ 1 1 1 1 1 2 3 0 0 0 1 }{ 1 1 1 1 1 2 3 0 0 0 1 }{ 1 1 1 1 1 2 3 0 0 0 1 }{ 1 1 1 1 1 2 3 0 0 0 1 }{ 1 1 1 1 1 2 3 0 0 0 1 }
1{ 1 27 27 26 26 2 3 0 0 0 1 }{ 0 0 0 0 0 27 26 0 0 0 1 }{ 0 0 0 0 0 27 26 0 0 0 1 }{ 0 0 0 0 0 27 26 0 0 0 1 }{ 1 27 27 26 26 2 3 0 0 0 1 }{ 0 0 0 0 0 2 3 0 0 0 1 }{ 0 0 0 0 0 2 3 0 0 0 1 }{ 0 0 0 0 0 2 3 0 0 0 1 }{ 0 0 0 0 0 2 3 0 0 0 1 }{ 0 0 0 0 0 2 3 0 0 0 1 }{ 0 0 0 0 0 2 3 0 0 0 1 }{ 0 0 0 0 0 2 3 0 0 0 1 }{ 0 0 0 0 0 2 3 0 0 0 1 }{ 0 0 0 0 0 2 3 0 0 0 1 }{ 0 0 0 0 0 2 3 0 0 0 1 }{ 0 0 0 0 0 2 3 0 0 0 1 }{ 0 0 0 0 0 2 3 0 0 0 1 }{ 0 0 0 0 0 2 3 0 0 0 1 }{ 0 0 0 0 0 2 3 0 0 0 1 }{ 0 0 0 0 0 2 3 0 0 0 1 }{ 0 0 0 0 0 2 3 0 0 0 1 }{ 0 0 0 0 0 2 3 0 0 0 1 }{ 0 0 0 0 0 2 3 0 0 0 1 }{ 0 0 0 0 0 2 3 0 0 0 1 }{ 0 0 0 0 0 2 3 0 0 0 1 }{ 0 0 0 0 0 2 3 0 0 0 1 }{ 0 0 0 0 0 2 3 0 0 0 1 }{ 0 0 0 0 0 2 3 0 0 0 1 }{ 0 0 0 0 0 2 3 0 0 0 1 }{ 0 0 0 0 0 2 3 0 0 0 1 }{ 0 0 0 0 0 2 3 0 0 0 1 }{ 1 1 1 1 1 2 3 0 0 0 1 }
2{ 1 27 27 26 26 2 3 0 0 0 1 }{ 0 0 0 0 0 27 26 0 0 0 1 }{ 0 0 0 0 0 27 26 0 0 0 1 }{ 0 0 0 0 0 27 26 0 0 0 1 }{ 1 27 27 26 26 2 3 0 0 0 1 }{ 0 0 0 0 0 2 3 0 0 0 1 }{ 0 0 0 0 0 2 3 0 0 0 1 }{ 0 0 0 0 0 2 3 0 0 0 1 }{ 0 0 0 0 0 2 3 0 0 0 1 }{ 0 0 0 0 0 2 3 0 0 0 1 }{ 0 0 0 0 0 2 3 0 0 0 1 }{ 0 0 0 0 0 2 3 0 0 0 1 }{ 0 0 0 0 0 2 3 0 0 0 1 }{ 0 0 0 0 0 2 3 0 0 0 1 }{ 0 0 0 0 0 2 3 0 0 0 1 }{ 0 0 0 0 0 2 3 0 0 0 1 }{ 0 0 0 0 0 2 3 0 0 0 1 }{ 0 0 0 0 0 2 3 0 0 0 1 }{ 0 0 0 0 0 2 3 0 0 0 1 }{ 0 0 0 0 0 2 3 0 0 0 1 }{ 0 0 0 0 0 2 3 0 0 0 1 }{ 0 0 0 0 0 2 3 0 0 0 1 }{ 0 0 0 0 0 2 3 0 0 0 1 }{ 0 0 0 0 0 2 3 0 0 0 1 }{ 0 0 0 0 0 2 3 0 0 0 1 }{ 0 0 0 0 0 2 3 0 0 0 1 }{ 0 0 0 0 0 2 3 0 0 0 1 }{ 0 0 0 0 0 2 3 0 0 0 1 }{ 0 0 0 0 0 2 3 0 0 0 1 }{ 0 0 0 0 0 2 3 0 0 0 1 }{ 0 0 0 0 0 2 3 0 0 0 1 }{ 1 1 1 1 1 2 3 0 0 0 1 }
3{ 1 27 27 10 26 2 3 0 0 0 1 }{ 0 0 0 0 0 27 26 0 0 0 1 }{ 0 0 0 0 0 27 28 0 0 0 1 }{ 0 0 0 0 0 27 26 0 0 0 1 }{ 1 28 27 26 26 2 3 0 0 0 1 }{ 0 0 0 0 0 2 3 0 0 0 1 }{ 0 0 0 0 0 2 3 0 0 0 1 }{ 0 0 0 0 0 2 3 0 0 0 1 }{ 0 0 0 0 0 2 3 0 0 0 1 }{ 0 0 0 0 0 2 3 0 0 0 1 }{ 0 0 0 0 0 2 3 0 0 0 1 }{ 0 0 0 0 0 2 3 0 0 0 1 }{ 0 0 0 0 0 2 3 0 0 0 1 }{ 0 0 0 0 0 2 3 0 0 0 1 }{ 0 0 0 0 0 2 3 0 0 0 1 }{ 0 0 0 0 0 2 3 0 0 0 1 }{ 0 0 0 0 0 2 3 0 0 0 1 }{ 0 0 0 0 0 2 3 0 0 0 1 }{ 0 0 0 0 0 2 3 0 0 0 1 }{ 0 0 0 0 0 2 3 0 0 0 1 }{ 0 0 0 0 0 2 3 0 0 0 1 }{ 0 0 0 0 0 2 3 0 0 0 1 }{ 0 0 0 0 0 2 3 0 0 0 1 }{ 0 0 0 0 0 2 3 0 0 0 1 }{ 0 0 0 0 0 2 3 0 0 0 1 }{ 0 0 0 0 0 2 3 0 0 0 1 }{ 0 0 0 0 0 2 3 0 0 0 1 }{ 0 0 0 0 0 2 3 0 0 0 1 }{ 0 0 0 0 0 2 3 0 0 0 1 }{ 0 0 0 0 0 2 3 0 0 0 1 }{ 0 0 0 0 0 2 3 0 0 0 1 }{ 1 1 1 1 1 2 3 0 0 0 1 }
4{ 1 27 27 26 26 2 3 0 0 0 1 }{ 0 0 0 0 0 8 26 0 0 0 1 }{ 0 0 0 0 0 8 26 0 0 0 1 }{ 0 0 0 0 0 8 26 0 0 0 1 }{ 1 21 27 26 26 2 3 0 0 0 1 }{ 0 0 0 0 0 2 3 0 0 0 1 }{ 0 0 0 0 0 2 3 0 0 0 1 }{ 0 0 0 0 0 2 3 0 0 0 1 }{ 0 0 0 0 0 2 3 0 0 0 1 }{ 0 0 0 0 0 2 3 0 0 0 1 }{ 0 0 0 0 0 2 3 0 0 0 1 }{ 0 0 0 0 0 2 3 0 0 0 1 }{ 0 0 0 0 0 2 3 0 0 0 1 }{ 0 0 0 0 0 2 3 0 0 0 1 }{ 0 0 0 0 0 2 3 0 0 0 1 }{ 0 0 0 0 0 2 3 0 0 0 1 }{ 0 0 0 0 0 2 3 0 0 0 1 }{ 0 0 0 0 0 2 3 0 0 0 1 }{ 0 0 0 0 0 2 3 0 0 0 1 }{ 0 0 0 0 0 2 3 0 0 0 1 }{ 0 0 0 0 0 2 3 0 0 0 1 }{ 0 0 0 0 0 2 3 0 0 0 1 }{ 0 0 0 0 0 2 3 0 0 0 1 }{ 0 0 0 0 0 2 3 0 0 0 1 }{ 0 0 0 0 0 2 3 0 0 0 1 }{ 0 0 0 0 0 2 3 0 0 0 1 }{ 0 0 0 0 0 2 3 0 0 0 1 }{ 0 0 0 0 0 2 3 0 0 0 1 }{ 0 0 0 0 0 2 3 0 0 0 1 }{ 0 0 0 0 0 2 3 0 0 0 1 }{ 0 0 0 0 0 2 3 0 0 0 1 }{ 1 1 1 1 1 2 3 0 0 0 1 }
5{ 1 27 27 26 26 2 3 0 0 0 1 }{ 0 0 0 0 0 8 26 0 0 0 1 }{ 0 0 0 0 0 8 26 0 0 0 1 }{ 0 0 0 0 0 27 26 0 0 0 1 }{ 1 27 27 26 26 2 3 0 0 0 1 }{ 0 0 0 0 0 2 3 0 0 0 1 }{ 0 0 0 0 0 2 3 0 0 0 1 }{ 0 0 0 0 0 2 3 0 0 0 1 }{ 0 0 0 0 0 2 3 0 0 0 1 }{ 0 0 0 0 0 2 3 0 0 0 1 }{ 0 0 0 0 0 2 3 0 0 0 1 }{ 0 0 0 0 0 2 3 0 0 0 1 }{ 0 0 0 0 0 2 3 0 0 0 1 }{ 0 0 0 0 0 2 3 0 0 0 1 }{ 0 0 0 0 0 2 3 0 0 0 1 }{ 0 0 0 0 0 2 3 0 0 0 1 }{ 0 0 0 0 0 2 3 0 0 0 1 }{ 0 0 0 0 0 2 3 0 0 0 1 }{ 0 0 0 0 0 2 3 0 0 0 1 }{ 0 0 0 0 0 2 3 0 0 0 1 }{ 0 0 0 0 0 2 3 0 0 0 1 }{ 0 0 0 0 0 2 3 0 0 0 1 }{ 0 0 0 0 0 2 3 0 0 0 1 }{ 0 0 0 0 0 2 3 0 0 0 1 }{ 0 0 0 0 0 2 3 0 0 0 1 }{ 0 0 0 0 0 2 3 0 0 0 1 }{ 0 0 0 0 0 2 3 0 0 0 1 }{ 0 0 0 0 0 2 3 0 0 0 1 }{ 0 0 0 0 0 2 3 0 0 0 1 }{ 0 0 0 0 0 2 3 0 0 0 1 }{ 0 0 0 0 0 2 3 0 0 0 1 }{ 1 1 1 1 1 2 3 0 0 0 1 }
6{ 1 27 27 1 2 2 3 0 0 0 1 }{ 1 27 10 26 10 2 3 0 0 0 1 }{ 0 0 0 0 0 2 3 0 10 1 1 }{ 1 27 10 26 10 2 3 0 0 0 1 }{ 1 27 27 26 26 2 3 0 0 0 1 }{ 0 0 0 0 0 2 3 0 0 0 1 }{ 0 0 0 0 0 2 3 0 0 0 1 }{ 0 0 0 0 0 2 3 0 0 0 1 }{ 0 0 0 0 0 2 3 0 0 0 1 }{ 0 0 0 0 0 2 3 0 0 0 1 }{ 0 0 0 0 0 2 3 0 0 0 1 }{ 0 0 0 0 0 2 3 0 0 0 1 }{ 0 0 0 0 0 2 3 0 0 0 1 }{ 0 0 0 0 0 2 3 0 0 0 1 }{ 0 0 0 0 0 2 3 0 0 0 1 }{ 0 0 0 0 0 2 3 0 0 0 1 }{ 0 0 0 0 0 2 3 0 0 0 1 }{ 0 0 0 0 0 2 3 0 0 0 1 }{ 0 0 0 0 0 2 3 0 0 0 1 }{ 0 0 0 0 0 2 3 0 0 0 1 }{ 0 0 0 0 0 2 3 0 0 0 1 }{ 0 0 0 0 0 2 3 0 0 0 1 }{ 0 0 0 0 0 2 3 0 0 0 1 }{ 0 0 0 0 0 2 3 0 0 0 1 }{ 0 0 0 0 0 2 3 0 0 0 1 }{ 0 0 0 0 0 2 3 0 0 0 1 }{ 0 0 0 0 0 2 3 0 0 0 1 }{ 0 0 0 0 0 2 3 0 0 0 1 }{ 0 0 0 0 0 2 3 0 0 0 1 }{ 0 0 0 0 0 2 3 0 0 0 1 }{ 0 0 0 0 0 2 3 0 0 0 1 }{ 1 1 1 1 1 2 3 0 0 0 1 }
7{ 1 27 27 26 26 2 3 0 0 0 1 }{ 0 0 0 0 0 2 3 0 0 0 1 }{ 0 0 0 0 0 2 3 0 0 0 1 }{ 0 0 0 0 0 2 3 0 0 0 1 }{ 0 0 0 0 0 2 3 0 0 0 1 }{ 0 0 0 0 0 2 3 0 0 0 1 }{ 0 0 0 0 0 2 3 0 0 0 1 }{ 0 0 0 0 0 2 3 0 0 0 1 }{ 0 0 0 0 0 2 3 0 0 0 1 }{ 0 0 0 0 0 2 3 0 0 0 1 }{ 0 0 0 0 0 2 3 0 0 0 1 }{ 0 0 0 0 0 2 3 0 0 0 1 }{ 0 0 0 0 0 2 3 0 0 0 1 }{ 0 0 0 0 0 2 3 0 0 0 1 }{ 0 0 0 0 0 2 3 0 0 0 1 }{ 0 0 0 0 0 2 3 0 0 0 1 }{ 0 0 0 0 0 2 3 0 0 0 1 }{ 0 0 0 0 0 2 3 0 0 0 1 }{ 0 0 0 0 0 2 3 0 0 0 1 }{ 0 0 0 0 0 2 3 0 0 0 1 }{ 0 0 0 0 0 2 3 0 0 0 1 }{ 0 0 0 0 0 2 3 0 0 0 1 }{ 0 0 0 0 0 2 3 0 0 0 1 }{ 0 0 0 0 0 2 3 0 0 0 1 }{ 0 0 0 0 0 2 3 0 0 0 1 }{ 0 0 0 0 0 2 3 0 0 0 1 }{ 0 0 0 0 0 2 3 0 0 0 1 }{ 0 0 0 0 0 2 3 0 0 0 1 }{ 0 0 0 0 0 2 3 0 0 0 1 }{ 0 0 0 0 0 2 3 0 0 0 1 }{ 0 0 0 0 0 2 3 0 0 0 1 }{ 1 1 1 1 1 2 3 0 0 0 1 }
8{ 1 27 27 26 26 2 3 0 0 0 1 }{ 0 0 0 0 0 2 3 0 0 0 1 }{ 0 0 0 0 0 2 3 0 0 0 1 }{ 0 0 0 0 0 2 3 0 0 0 1 }{ 0 0 0 0 0 2 3 0 0 0 1 }{ 0 0 0 0 0 2 3 0 0 0 1 }{ 0 0 0 0 0 2 3 0 0 0 1 }{ 0 0 0 0 0 2 3 0 0 0 1 }{ 0 0 0 0 0 2 3 0 0 0 1 }{ 0 0 0 0 0 2 3 0 0 0 1 }{ 0 0 0 0 0 2 3 0 0 0 1 }{ 0 0 0 0 0 2 3 0 0 0 1 }{ 0 0 0 0 0 2 3 0 0 0 1 }{ 0 0 0 0 0 2 3 0 0 0 1 }{ 0 0 0 0 0 2 3 0 0 0 1 }{ 0 0 0 0 0 2 3 0 0 0 1 }{ 0 0 0 0 0 2 3 0 0 0 1 }{ 0 0 0 0 0 2 3 0 0 0 1 }{ 0 0 0 0 0 2 3 0 0 0 1 }{ 0 0 0 0 0 2 3 0 0 0 1 }{ 0 0 0 0 0 2 3 0 0 0 1 }{ 0 0 0 0 0 2 3 0 0 0 1 }{ 0 0 0 0 0 2 3 0 0 0 1 }{ 0 0 0 0 0 2 3 0 0 0 1 }{ 0 0 0 0 0 2 3 0 0 0 1 }{ 0 0 0 0 0 2 3 0 0 0 1 }{ 0 0 0 0 0 2 3 0 0 0 1 }{ 0 0 0 0 0 2 3 0 0 0 1 }{ 0 0 0 0 0 2 3 0 0 0 1 }{ 0 0 0 0 0 2 3 0 0 0 1 }{ 0 0 0 0 0 2 3 0 0 0 1 }{ 1 1 1 1 1 2 3 0 0 0 1 }
9{ 1 27 27 26 26 2 3 0 0 0 1 }{ 0 0 0 0 0 2 3 0 0 0 1 }{ 0 0 0 0 0 2 3 0 0 0 1 }{ 0 0 0 0 0 2 3 0 0 0 1 }{ 0 0 0 0 0 2 3 0 0 0 1 }{ 0 0 0 0 0 2 3 0 0 0 1 }{ 0 0 0 0 0 2 3 0 0 0 1 }{ 0 0 0 0 0 2 3 0 0 0 1 }{ 0 0 0 0 0 2 3 0 0 0 1 }{ 0 0 0 0 0 2 3 0 0 0 1 }{ 0 0 0 0 0 2 3 0 0 0 1 }{ 0 0 0 0 0 2 3 0 0 0 1 }{ 0 0 0 0 0 2 3 0 0 0 1 }{ 0 0 0 0 0 2 3 0 0 0 1 }{ 0 0 0 0 0 2 3 0 0 0 1 }{ 0 0 0 0 0 2 3 0 0 0 1 }{ 0 0 0 0 0 2 3 0 0 0 1 }{ 0 0 0 0 0 2 3 0 0 0 1 }{ 0 0 0 0 0 2 3 0 0 0 1 }{ 0 0 0 0 0 2 3 0 0 0 1 }{ 0 0 0 0 0 2 3 0 0 0 1 }{ 0 0 0 0 0 2 3 0 0 0 1 }{ 0 0 0 0 0 2 3 0 0 0 1 }{ 0 0 0 0 0 2 3 0 0 0 1 }{ 0 0 0 0 0 2 3 0 0 0 1 }{ 0 0 0 0 0 2 3 0 0 0 1 }{ 0 0 0 0 0 2 3 0 0 0 1 }{ 0 0 0 0 0 2 3 0 0 0 1 }{ 0 0 0 0 0 2 3 0 0 0 1 }{ 0 0 0 0 0 2 3 0 0 0 1 }{ 0 0 0 0 0 2 3 0 0 0 1 }{ 1 1 1 1 1 2 3 0 0 0 1 }
10{ 1 1 1 1 1 2 3 0 0 0 1 }{ 0 0 0 0 0 2 3 0 0 0 1 }{ 0 0 0 0 0 2 3 0 0 0 1 }{ 0 0 0 0 0 2 3 0 0 0 1 }{ 0 0 0 0 0 2 3 0 0 0 1 }{ 0 0 0 0 0 2 3 0 0 0 1 }{ 0 0 0 0 0 2 3 0 0 0 1 }{ 0 0 0 0 0 2 3 0 0 0 1 }{ 0 0 0 0 0 2 3 0 0 0 1 }{ 0 0 0 0 0 2 3 0 0 0 1 }{ 0 0 0 0 0 2 3 0 0 0 1 }{ 0 0 0 0 0 2 3 0 0 0 1 }{ 0 0 0 0 0 2 3 0 0 0 1 }{ 0 0 0 0 0 2 3 0 0 0 1 }{ 0 0 0 0 0 2 3 0 0 0 1 }{ 0 0 0 0 0 2 3 0 0 0 1 }{ 0 0 0 0 0 2 3 0 0 0 1 }{ 0 0 0 0 0 2 3 0 0 0 1 }{ 0 0 0 0 0 2 3 0 0 0 1 }{ 0 0 0 0 0 2 3 0 0 0 1 }{ 0 0 0 0 0 2 3 0 0 0 1 }{ 0 0 0 0 0 2 3 0 0 0 1 }{ 0 0 0 0 0 2 3 0 0 0 1 }{ 0 0 0 0 0 2 3 0 0 0 1 }{ 0 0 0 0 0 2 3 0 0 0 1 }{ 0 0 0 0 0 2 3 0 0 0 1 }{ 0 0 0 0 0 2 3 0 0 0 1 }{ 0 0 0 0 0 2 3 0 0 0 1 }{ 0 0 0 0 0 2 3 0 0 0 1 }{ 0 0 0 0 0 2 3 0 0 0 1 }{ 0 0 0 0 0 2 3 0 0 0 1 }{ 1 1 1 1 1 2 3 0 0 0 1 }
11{ 1 1 1 1 1 2 3 0 0 0 1 }{ 0 0 0 0 0 2 3 0 0 0 1 }{ 0 0 0 0 0 2 3 0 0 0 1 }{ 0 0 0 0 0 2 3 0 0 0 1 }{ 0 0 0 0 0 2 3 0 0 0 1 }{ 0 0 0 0 0 2 3 0 0 0 1 }{ 0 0 0 0 0 2 3 0 0 0 1 }{ 0 0 0 0 0 2 3 0 0 0 1 }{ 0 0 0 0 0 2 3 0 0 0 1 }{ 0 0 0 0 0 2 3 0 0 0 1 }{ 0 0 0 0 0 2 3 0 0 0 1 }{ 0 0 0 0 0 2 3 0 0 0 1 }{ 0 0 0 0 0 2 3 0 0 0 1 }{ 0 0 0 0 0 2 3 0 0 0 1 }{ 0 0 0 0 0 2 3 0 0 0 1 }{ 0 0 0 0 0 2 3 0 0 0 1 }{ 0 0 0 0 0 2 3 0 0 0 1 }{ 0 0 0 0 0 2 3 0 0 0 1 }{ 0 0 0 0 0 2 3 0 0 0 1 }{ 0 0 0 0 0 2 3 0 0 0 1 }{ 0 0 0 0 0 2 3 0 0 0 1 }{ 0 0 0 0 0 2 3 0 0 0 1 }{ 0 0 0 0 0 2 3 0 0 0 1 }{ 0 0 0 0 0 2 3 0 0 0 1 }{ 0 0 0 0 0 2 3 0 0 0 1 }{ 0 0 0 0 0 2 3 0 0 0 1 }{ 0 0 0 0 0 2 3 0 0 0 1 }{ 0 0 0 0 0 2 3 0 0 0 1 }{ 0 0 0 0 0 2 3 0 0 0 1 }{ 0 0 0 0 0 2 3 0 0 0 1 }{ 0 0 0 0 0 2 3 0 0 0 1 }{ 1 1 1 1 1 2 3 0 0 0 1 }
12{ 1 1 1 1 1 2 3 0 0 0 1 }{ 0 0 0 0 0 2 3 0 0 0 1 }{ 0 0 0 0 0 2 3 0 0 0 1 }{ 0 0 0 0 0 2 3 0 0 0 1 }{ 0 0 0 0 0 2 3 0 0 0 1 }{ 0 0 0 0 0 2 3 0 0 0 1 }{ 0 0 0 0 0 2 3 0 0 0 1 }{ 0 0 0 0 0 2 3 0 0 0 1 }{ 0 0 0 0 0 2 3 0 0 0 1 }{ 0 0 0 0 0 2 3 0 0 0 1 }{ 0 0 0 0 0 2 3 0 0 0 1 }{ 0 0 0 0 0 2 3 0 0 0 1 }{ 0 0 0 0 0 2 3 0 0 0 1 }{ 0 0 0 0 0 2 3 0 0 0 1 }{ 0 0 0 0 0 2 3 0 0 0 1 }{ 0 0 0 0 0 2 3 0 0 0 1 }{ 0 0 0 0 0 2 3 0 0 0 1 }{ 0 0 0 0 0 2 3 0 0 0 1 }{ 0 0 0 0 0 2 3 0 0 0 1 }{ 0 0 0 0 0 2 3 0 0 0 1 }{ 0 0 0 0 0 2 3 0 0 0 1 }{ 0 0 0 0 0 2 3 0 0 0 1 }{ 0 0 0 0 0 2 3 0 0 0 1 }{ 0 0 0 0 0 2 3 0 0 0 1 }{ 0 0 0 0 0 2 3 0 0 0 1 }{ 0 0 0 0 0 2 3 0 0 0 1 }{ 0 0 0 0 0 2 3 0 0 0 1 }{ 0 0 0 0 0 2 3 0 0 0 1 }{ 0 0 0 0 0 2 3 0 0 0 1 }{ 0 0 0 0 0 2 3 0 0 0 1 }{ 0 0 0 0 0 2 3 0 0 0 1 }{ 1 1 1 1 1 2 3 0 0 0 1 }
13{ 1 1 1 1 1 2 3 0 0 0 1 }{ 0 0 0 0 0 2 3 0 0 0 1 }{ 0 0 0 0 0 2 3 0 0 0 1 }{ 0 0 0 0 0 2 3 0 0 0 1 }{ 0 0 0 0 0 2 3 0 0 0 1 }{ 0 0 0 0 0 2 3 0 0 0 1 }{ 0 0 0 0 0 2 3 0 0 0 1 }{ 0 0 0 0 0 2 3 0 0 0 1 }{ 0 0 0 0 0 2 3 0 0 0 1 }{ 0 0 0 0 0 2 3 0 0 0 1 }{ 0 0 0 0 0 2 3 0 0 0 1 }{ 0 0 0 0 0 2 3 0 0 0 1 }{ 0 0 0 0 0 2 3 0 0 0 1 }{ 0 0 0 0 0 2 3 0 0 0 1 }{ 0 0 0 0 0 2 3 0 0 0 1 }{ 0 0 0 0 0 2 3 0 0 0 1 }{ 0 0 0 0 0 2 3 0 0 0 1 }{ 0 0 0 0 0 2 3 0 0 0 1 }{ 0 0 0 0 0 2 3 0 0 0 1 }{ 0 0 0 0 0 2 3 0 0 0 1 }{ 0 0 0 0 0 2 3 0 0 0 1 }{ 0 0 0 0 0 2 3 0 0 0 1 }{ 0 0 0 0 0 2 3 0 0 0 1 }{ 0 0 0 0 0 2 3 0 0 0 1 }{ 0 0 0 0 0 2 3 0 0 0 1 }{ 0 0 0 0 0 2 3 0 0 0 1 }{ 0 0 0 0 0 2 3 0 0 0 1 }{ 0 0 0 0 0 2 3 0 0 0 1 }{ 0 0 0 0 0 2 3 0 0 0 1 }{ 0 0 0 0 0 2 3 0 0 0 1 }{ 0 0 0 0 0 2 3 0 0 0 1 }{ 1 1 1 1 1 2 3 0 0 0 1 }
14{ 1 1 1 1 1 2 3 0 0 0 1 }{ 0 0 0 0 0 2 3 0 0 0 1 }{ 0 0 0 0 0 2 3 0 0 0 1 }{ 0 0 0 0 0 2 3 0 0 0 1 }{ 0 0 0 0 0 2 3 0 0 0 1 }{ 0 0 0 0 0 2 3 0 0 0 1 }{ 0 0 0 0 0 2 3 0 0 0 1 }{ 0 0 0 0 0 2 3 0 0 0 1 }{ 0 0 0 0 0 2 3 0 0 0 1 }{ 0 0 0 0 0 2 3 0 0 0 1 }{ 0 0 0 0 0 2 3 0 0 0 1 }{ 0 0 0 0 0 2 3 0 0 0 1 }{ 0 0 0 0 0 2 3 0 0 0 1 }{ 0 0 0 0 0 2 3 0 0 0 1 }{ 0 0 0 0 0 2 3 0 0 0 1 }{ 0 0 0 0 0 2 3 0 0 0 1 }{ 0 0 0 0 0 2 3 0 0 0 1 }{ 0 0 0 0 0 2 3 0 0 0 1 }{ 0 0 0 0 0 2 3 0 0 0 1 }{ 0 0 0 0 0 2 3 0 0 0 1 }{ 0 0 0 0 0 2 3 0 0 0 1 }{ 0 0 0 0 0 2 3 0 0 0 1 }{ 0 0 0 0 0 2 3 0 0 0 1 }{ 0 0 0 0 0 2 3 0 0 0 1 }{ 0 0 0 0 0 2 3 0 0 0 1 }{ 0 0 0 0 0 2 3 0 0 0 1 }{ 0 0 0 0 0 2 3 0 0 0 1 }{ 0 0 0 0 0 2 3 0 0 0 1 }{ 0 0 0 0 0 2 3 0 0 0 1 }{ 0 0 0 0 0 2 3 0 0 0 1 }{ 0 0 0 0 0 2 3 0 0 0 1 }{ 1 1 1 1 1 2 3 0 0 0 1 }
15{ 1 1 1 1 1 2 3 0 0 0 1 }{ 0 0 0 0 0 2 3 0 0 0 1 }{ 0 0 0 0 0 2 3 0 0 0 1 }{ 0 0 0 0 0 2 3 0 0 0 1 }{ 0 0 0 0 0 2 3 0 0 0 1 }{ 0 0 0 0 0 2 3 0 0 0 1 }{ 0 0 0 0 0 2 3 0 0 0 1 }{ 0 0 0 0 0 2 3 0 0 0 1 }{ 0 0 0 0 0 2 3 0 0 0 1 }{ 0 0 0 0 0 2 3 0 0 0 1 }{ 0 0 0 0 0 2 3 0 0 0 1 }{ 0 0 0 0 0 2 3 0 0 0 1 }{ 0 0 0 0 0 2 3 0 0 0 1 }{ 0 0 0 0 0 2 3 0 0 0 1 }{ 0 0 0 0 0 2 3 0 0 0 1 }{ 0 0 0 0 0 2 3 0 0 0 1 }{ 0 0 0 0 0 2 3 0 0 0 1 }{ 0 0 0 0 0 2 3 0 0 0 1 }{ 0 0 0 0 0 2 3 0 0 0 1 }{ 0 0 0 0 0 2 3 0 0 0 1 }{ 0 0 0 0 0 2 3 0 0 0 1 }{ 0 0 0 0 0 2 3 0 0 0 1 }{ 0 0 0 0 0 2 3 0 0 0 1 }{ 0 0 0 0 0 2 3 0 0 0 1 }{ 0 0 0 0 0 2 3 0 0 0 1 }{ 0 0 0 0 0 2 3 0 0 0 1 }{ 0 0 0 0 0 2 3 0 0 0 1 }{ 0 0 0 0 0 2 3 0 0 0 1 }{ 0 0 0 0 0 2 3 0 0 0 1 }{ 0 0 0 0 0 2 3 0 0 0 1 }{ 0 0 0 0 0 2 3 0 0 0 1 }{ 1 1 1 1 1 2 3 0 0 0 1 }
16{ 1 1 1 1 1 2 3 0 0 0 1 }{ 0 0 0 0 0 2 3 0 0 0 1 }{ 0 0 0 0 0 2 3 0 0 0 1 }{ 0 0 0 0 0 2 3 0 0 0 1 }{ 0 0 0 0 0 2 3 0 0 0 1 }{ 0 0 0 0 0 2 3 0 0 0 1 }{ 0 0 0 0 0 2 3 0 0 0 1 }{ 0 0 0 0 0 2 3 0 0 0 1 }{ 0 0 0 0 0 2 3 0 0 0 1 }{ 0 0 0 0 0 2 3 0 0 0 1 }{ 0 0 0 0 0 2 3 0 0 0 1 }{ 0 0 0 0 0 2 3 0 0 0 1 }{ 0 0 0 0 0 2 3 0 0 0 1 }{ 0 0 0 0 0 2 3 0 0 0 1 }{ 0 0 0 0 0 2 3 0 0 0 1 }{ 0 0 0 0 0 2 3 0 0 0 1 }{ 0 0 0 0 0 2 3 0 0 0 1 }{ 0 0 0 0 0 2 3 0 0 0 1 }{ 0 0 0 0 0 2 3 0 0 0 1 }{ 0 0 0 0 0 2 3 0 0 0 1 }{ 0 0 0 0 0 2 3 0 0 0 1 }{ 0 0 0 0 0 2 3 0 0 0 1 }{ 0 0 0 0 0 2 3 0 0 0 1 }{ 0 0 0 0 0 2 3 0 0 0 1 }{ 0 0 0 0 0 2 3 0 0 0 1 }{ 0 0 0 0 0 2 3 0 0 0 1 }{ 0 0 0 0 0 2 3 0 0 0 1 }{ 0 0 0 0 0 2 3 0 0 0 1 }{ 0 0 0 0 0 2 3 0 0 0 1 }{ 0 0 0 0 0 2 3 0 0 0 1 }{ 0 0 0 0 0 2 3 0 0 0 1 }{ 1 1 1 1 1 2 3 0 0 0 1 }
17{ 1 1 1 1 1 2 3 0 0 0 1 }{ 0 0 0 0 0 2 3 0 0 0 1 }{ 0 0 0 0 0 2 3 0 0 0 1 }{ 0 0 0 0 0 2 3 0 0 0 1 }{ 0 0 0 0 0 2 3 0 0 0 1 }{ 0 0 0 0 0 2 3 0 0 0 1 }{ 0 0 0 0 0 2 3 0 0 0 1 }{ 0 0 0 0 0 2 3 0 0 0 1 }{ 0 0 0 0 0 2 3 0 0 0 1 }{ 0 0 0 0 0 2 3 0 0 0 1 }{ 0 0 0 0 0 2 3 0 0 0 1 }{ 0 0 0 0 0 2 3 0 0 0 1 }{ 0 0 0 0 0 2 3 0 0 0 1 }{ 0 0 0 0 0 2 3 0 0 0 1 }{ 0 0 0 0 0 2 3 0 0 0 1 }{ 0 0 0 0 0 2 3 0 0 0 1 }{ 0 0 0 0 0 2 3 0 0 0 1 }{ 0 0 0 0 0 2 3 0 0 0 1 }{ 0 0 0 0 0 2 3 0 0 0 1 }{ 0 0 0 0 0 2 3 0 0 0 1 }{ 0 0 0 0 0 2 3 0 0 0 1 }{ 0 0 0 0 0 2 3 0 0 0 1 }{ 0 0 0 0 0 2 3 0 0 0 1 }{ 0 0 0 0 0 2 3 0 0 0 1 }{ 0 0 0 0 0 2 3 0 0 0 1 }{ 0 0 0 0 0 2 3 0 0 0 1 }{ 0 0 0 0 0 2 3 0 0 0 1 }{ 0 0 0 0 0 2 3 0 0 0 1 }{ 0 0 0 0 0 2 3 0 0 0 1 }{ 0 0 0 0 0 2 3 0 0 0 1 }{ 0 0 0 0 0 2 3 0 0 0 1 }{ 1 1 1 1 1 2 3 0 0 0 1 }
18{ 1 1 1 1 1 2 3 0 0 0 1 }{ 0 0 0 0 0 2 3 0 0 0 1 }{ 0 0 0 0 0 2 3 0 0 0 1 }{ 0 0 0 0 0 2 3 0 0 0 1 }{ 0 0 0 0 0 2 3 0 0 0 1 }{ 0 0 0 0 0 2 3 0 0 0 1 }{ 0 0 0 0 0 2 3 0 0 0 1 }{ 0 0 0 0 0 2 3 0 0 0 1 }{ 0 0 0 0 0 2 3 0 0 0 1 }{ 0 0 0 0 0 2 3 0 0 0 1 }{ 0 0 0 0 0 2 3 0 0 0 1 }{ 0 0 0 0 0 2 3 0 0 0 1 }{ 0 0 0 0 0 2 3 0 0 0 1 }{ 0 0 0 0 0 2 3 0 0 0 1 }{ 0 0 0 0 0 2 3 0 0 0 1 }{ 0 0 0 0 0 2 3 0 0 0 1 }{ 0 0 0 0 0 2 3 0 0 0 1 }{ 0 0 0 0 0 2 3 0 0 0 1 }{ 0 0 0 0 0 2 3 0 0 0 1 }{ 0 0 0 0 0 2 3 0 0 0 1 }{ 0 0 0 0 0 2 3 0 0 0 1 }{ 0 0 0 0 0 2 3 0 0 0 1 }{ 0 0 0 0 0 2 3 0 0 0 1 }{ 0 0 0 0 0 2 3 0 0 0 1 }{ 0 0 0 0 0 2 3 0 0 0 1 }{ 0 0 0 0 0 2 3 0 0 0 1 }{ 0 0 0 0 0 2 3 0 0 0 1 }{ 0 0 0 0 0 2 3 0 0 0 1 }{ 0 0 0 0 0 2 3 0 0 0 1 }{ 0 0 0 0 0 2 3 0 0 0 1 }{ 0 0 0 0 0 2 3 0 0 0 1 }{ 1 1 1 1 1 2 3 0 0 0 1 }
19{ 1 1 1 1 1 2 3 0 0 0 1 }{ 0 0 0 0 0 2 3 0 0 0 1 }{ 0 0 0 0 0 2 3 0 0 0 1 }{ 0 0 0 0 0 2 3 0 0 0 1 }{ 0 0 0 0 0 2 3 0 0 0 1 }{ 0 0 0 0 0 2 3 0 0 0 1 }{ 0 0 0 0 0 2 3 0 0 0 1 }{ 0 0 0 0 0 2 3 0 0 0 1 }{ 0 0 0 0 0 2 3 0 0 0 1 }{ 0 0 0 0 0 2 3 0 0 0 1 }{ 0 0 0 0 0 2 3 0 0 0 1 }{ 0 0 0 0 0 2 3 0 0 0 1 }{ 0 0 0 0 0 2 3 0 0 0 1 }{ 0 0 0 0 0 2 3 0 0 0 1 }{ 0 0 0 0 0 2 3 0 0 0 1 }{ 0 0 0 0 0 2 3 0 0 0 1 }{ 0 0 0 0 0 2 3 0 0 0 1 }{ 0 0 0 0 0 2 3 0 0 0 1 }{ 0 0 0 0 0 2 3 0 0 0 1 }{ 0 0 0 0 0 2 3 0 0 0 1 }{ 0 0 0 0 0 2 3 0 0 0 1 }{ 0 0 0 0 0 2 3 0 0 0 1 }{ 0 0 0 0 0 2 3 0 0 0 1 }{ 0 0 0 0 0 2 3 0 0 0 1 }{ 0 0 0 0 0 2 3 0 0 0 1 }{ 0 0 0 0 0 2 3 0 0 0 1 }{ 0 0 0 0 0 2 3 0 0 0 1 }{ 0 0 0 0 0 2 3 0 0 0 1 }{ 0 0 0 0 0 2 3 0 0 0 1 }{ 0 0 0 0 0 2 3 0 0 0 1 }{ 0 0 0 0 0 2 3 0 0 0 1 }{ 1 1 1 1 1 2 3 0 0 0 1 }
20{ 1 1 1 1 1 2 3 0 0 0 1 }{ 0 0 0 0 0 2 3 0 0 0 1 }{ 0 0 0 0 0 2 3 0 0 0 1 }{ 0 0 0 0 0 2 3 0 0 0 1 }{ 0 0 0 0 0 2 3 0 0 0 1 }{ 0 0 0 0 0 2 3 0 0 0 1 }{ 0 0 0 0 0 2 3 0 0 0 1 }{ 0 0 0 0 0 2 3 0 0 0 1 }{ 0 0 0 0 0 2 3 0 0 0 1 }{ 0 0 0 0 0 2 3 0 0 0 1 }{ 0 0 0 0 0 2 3 0 0 0 1 }{ 0 0 0 0 0 2 3 0 0 0 1 }{ 0 0 0 0 0 2 3 0 0 0 1 }{ 0 0 0 0 0 2 3 0 0 0 1 }{ 0 0 0 0 0 2 3 0 0 0 1 }{ 0 0 0 0 0 2 3 0 0 0 1 }{ 0 0 0 0 0 2 3 0 0 0 1 }{ 0 0 0 0 0 2 3 0 0 0 1 }{ 0 0 0 0 0 2 3 0 0 0 1 }{ 0 0 0 0 0 2 3 0 0 0 1 }{ 0 0 0 0 0 2 3 0 0 0 1 }{ 0 0 0 0 0 2 3 0 0 0 1 }{ 0 0 0 0 0 2 3 0 0 0 1 }{ 0 0 0 0 0 2 3 0 0 0 1 }{ 0 0 0 0 0 2 3 0 0 0 1 }{ 0 0 0 0 0 2 3 0 0 0 1 }{ 0 0 0 0 0 2 3 0 0 0 1 }{ 0 0 0 0 0 2 3 0 0 0 1 }{ 0 0 0 0 0 2 3 0 0 0 1 }{ 0 0 0 0 0 2 3 0 0 0 1 }{ 0 0 0 0 0 2 3 0 0 0 1 }{ 1 1 1 1 1 2 3 0 0 0 1 }
21{ 1 1 1 1 1 2 3 0 0 0 1 }{ 0 0 0 0 0 2 3 0 0 0 1 }{ 0 0 0 0 0 2 3 0 0 0 1 }{ 0 0 0 0 0 2 3 0 0 0 1 }{ 0 0 0 0 0 2 3 0 0 0 1 }{ 0 0 0 0 0 2 3 0 0 0 1 }{ 0 0 0 0 0 2 3 0 0 0 1 }{ 0 0 0 0 0 2 3 0 0 0 1 }{ 0 0 0 0 0 2 3 0 0 0 1 }{ 0 0 0 0 0 2 3 0 0 0 1 }{ 0 0 0 0 0 2 3 0 0 0 1 }{ 0 0 0 0 0 2 3 0 0 0 1 }{ 0 0 0 0 0 2 3 0 0 0 1 }{ 0 0 0 0 0 2 3 0 0 0 1 }{ 0 0 0 0 0 2 3 0 0 0 1 }{ 0 0 0 0 0 2 3 0 0 0 1 }{ 0 0 0 0 0 2 3 0 0 0 1 }{ 0 0 0 0 0 2 3 0 0 0 1 }{ 0 0 0 0 0 2 3 0 0 0 1 }{ 0 0 0 0 0 2 3 0 0 0 1 }{ 0 0 0 0 0 2 3 0 0 0 1 }{ 0 0 0 0 0 2 3 0 0 0 1 }{ 0 0 0 0 0 2 3 0 0 0 1 }{ 0 0 0 0 0 2 3 0 0 0 1 }{ 0 0 0 0 0 2 3 0 0 0 1 }{ 0 0 0 0 0 2 3 0 0 0 1 }{ 0 0 0 0 0 2 3 0 0 0 1 }{ 0 0 0 0 0 2 3 0 0 0 1 }{ 0 0 0 0 0 2 3 0 0 0 1 }{ 0 0 0 0 0 2 3 0 0 0 1 }{ 0 0 0 0 0 2 3 0 0 0 1 }{ 1 1 1 1 1 2 3 0 0 0 1 }
22{ 1 1 1 1 1 2 3 0 0 0 1 }{ 0 0 0 0 0 2 3 0 0 0 1 }{ 0 0 0 0 0 2 3 0 0 0 1 }{ 0 0 0 0 0 2 3 0 0 0 1 }{ 0 0 0 0 0 2 3 0 0 0 1 }{ 0 0 0 0 0 2 3 0 0 0 1 }{ 0 0 0 0 0 2 3 0 0 0 1 }{ 0 0 0 0 0 2 3 0 0 0 1 }{ 0 0 0 0 0 2 3 0 0 0 1 }{ 0 0 0 0 0 2 3 0 0 0 1 }{ 0 0 0 0 0 2 3 0 0 0 1 }{ 0 0 0 0 0 2 3 0 0 0 1 }{ 0 0 0 0 0 2 3 0 0 0 1 }{ 0 0 0 0 0 2 3 0 0 0 1 }{ 0 0 0 0 0 2 3 0 0 0 1 }{ 0 0 0 0 0 2 3 0 0 0 1 }{ 0 0 0 0 0 2 3 0 0 0 1 }{ 0 0 0 0 0 2 3 0 0 0 1 }{ 0 0 0 0 0 2 3 0 0 0 1 }{ 0 0 0 0 0 2 3 0 0 0 1 }{ 0 0 0 0 0 2 3 0 0 0 1 }{ 0 0 0 0 0 2 3 0 0 0 1 }{ 0 0 0 0 0 2 3 0 0 0 1 }{ 0 0 0 0 0 2 3 0 0 0 1 }{ 0 0 0 0 0 2 3 0 0 0 1 }{ 0 0 0 0 0 2 3 0 0 0 1 }{ 0 0 0 0 0 2 3 0 0 0 1 }{ 0 0 0 0 0 2 3 0 0 0 1 }{ 0 0 0 0 0 2 3 0 0 0 1 }{ 0 0 0 0 0 2 3 0 0 0 1 }{ 0 0 0 0 0 2 3 0 0 0 1 }{ 1 1 1 1 1 2 3 0 0 0 1 }
23{ 1 1 1 1 1 2 3 0 0 0 1 }{ 0 0 0 0 0 2 3 0 0 0 1 }{ 0 0 0 0 0 2 3 0 0 0 1 }{ 0 0 0 0 0 2 3 0 0 0 1 }{ 0 0 0 0 0 2 3 0 0 0 1 }{ 0 0 0 0 0 2 3 0 0 0 1 }{ 0 0 0 0 0 2 3 0 0 0 1 }{ 0 0 0 0 0 2 3 0 0 0 1 }{ 0 0 0 0 0 2 3 0 0 0 1 }{ 0 0 0 0 0 2 3 0 0 0 1 }{ 0 0 0 0 0 2 3 0 0 0 1 }{ 0 0 0 0 0 2 3 0 0 0 1 }{ 0 0 0 0 0 2 3 0 0 0 1 }{ 0 0 0 0 0 2 3 0 0 0 1 }{ 0 0 0 0 0 2 3 0 0 0 1 }{ 0 0 0 0 0 2 3 0 0 0 1 }{ 0 0 0 0 0 2 3 0 0 0 1 }{ 0 0 0 0 0 2 3 0 0 0 1 }{ 0 0 0 0 0 2 3 0 0 0 1 }{ 0 0 0 0 0 2 3 0 0 0 1 }{ 0 0 0 0 0 2 3 0 0 0 1 }{ 0 0 0 0 0 2 3 0 0 0 1 }{ 0 0 0 0 0 2 3 0 0 0 1 }{ 0 0 0 0 0 2 3 0 0 0 1 }{ 0 0 0 0 0 2 3 0 0 0 1 }{ 0 0 0 0 0 2 3 0 0 0 1 }{ 0 0 0 0 0 2 3 0 0 0 1 }{ 0 0 0 0 0 2 3 0 0 0 1 }{ 0 0 0 0 0 2 3 0 0 0 1 }{ 0 0 0 0 0 2 3 0 0 0 1 }{ 0 0 0 0 0 2 3 0 0 0 1 }{ 1 1 1 1 1 2 3 0 0 0 1 }
24{ 1 1 1 1 1 2 3 0 0 0 1 }{ 0 0 0 0 0 2 3 0 0 0 1 }{ 0 0 0 0 0 2 3 0 0 0 1 }{ 0 0 0 0 0 2 3 0 0 0 1 }{ 0 0 0 0 0 2 3 0 0 0 1 }{ 0 0 0 0 0 2 3 0 0 0 1 }{ 0 0 0 0 0 2 3 0 0 0 1 }{ 0 0 0 0 0 2 3 0 0 0 1 }{ 0 0 0 0 0 2 3 0 0 0 1 }{ 0 0 0 0 0 2 3 0 0 0 1 }{ 0 0 0 0 0 2 3 0 0 0 1 }{ 0 0 0 0 0 2 3 0 0 0 1 }{ 0 0 0 0 0 2 3 0 0 0 1 }{ 0 0 0 0 0 2 3 0 0 0 1 }{ 0 0 0 0 0 2 3 0 0 0 1 }{ 0 0 0 0 0 2 3 0 0 0 1 }{ 0 0 0 0 0 2 3 0 0 0 1 }{ 0 0 0 0 0 2 3 0 0 0 1 }{ 0 0 0 0 0 2 3 0 0 0 1 }{ 0 0 0 0 0 2 3 0 0 0 1 }{ 0 0 0 0 0 2 3 0 0 0 1 }{ 0 0 0 0 0 2 3 0 0 0 1 }{ 0 0 0 0 0 2 3 0 0 0 1 }{ 0 0 0 0 0 2 3 0 0 0 1 }{ 0 0 0 0 0 2 3 0 0 0 1 }{ 0 0 0 0 0 2 3 0 0 0 1 }{ 0 0 0 0 0 2 3 0 0 0 1 }{ 0 0 0 0 0 2 3 0 0 0 1 }{ 0 0 0 0 0 2 3 0 0 0 1 }{ 0 0 0 0 0 2 3 0 0 0 1 }{ 0 0 0 0 0 2 3 0 0 0 1 }{ 1 1 1 1 1 2 3 0 0 0 1 }
25{ 1 1 1 1 1 2 3 0 0 0 1 }{ 0 0 0 0 0 2 3 0 0 0 1 }{ 0 0 0 0 0 2 3 0 0 0 1 }{ 0 0 0 0 0 2 3 0 0 0 1 }{ 0 0 0 0 0 2 3 0 0 0 1 }{ 0 0 0 0 0 2 3 0 0 0 1 }{ 0 0 0 0 0 2 3 0 0 0 1 }{ 0 0 0 0 0 2 3 0 0 0 1 }{ 0 0 0 0 0 2 3 0 0 0 1 }{ 0 0 0 0 0 2 3 0 0 0 1 }{ 0 0 0 0 0 2 3 0 0 0 1 }{ 0 0 0 0 0 2 3 0 0 0 1 }{ 0 0 0 0 0 2 3 0 0 0 1 }{ 0 0 0 0 0 2 3 0 0 0 1 }{ 0 0 0 0 0 2 3 0 0 0 1 }{ 0 0 0 0 0 2 3 0 0 0 1 }{ 0 0 0 0 0 2 3 0 0 0 1 }{ 0 0 0 0 0 2 3 0 0 0 1 }{ 0 0 0 0 0 2 3 0 0 0 1 }{ 0 0 0 0 0 2 3 0 0 0 1 }{ 0 0 0 0 0 2 3 0 0 0 1 }{ 0 0 0 0 0 2 3 0 0 0 1 }{ 0 0 0 0 0 2 3 0 0 0 1 }{ 0 0 0 0 0 2 3 0 0 0 1 }{ 0 0 0 0 0 2 3 0 0 0 1 }{ 0 0 0 0 0 2 3 0 0 0 1 }{ 0 0 0 0 0 2 3 0 0 0 1 }{ 0 0 0 0 0 2 3 0 0 0 1 }{ 0 0 0 0 0 2 3 0 0 0 1 }{ 0 0 0 0 0 2 3 0 0 0 1 }{ 0 0 0 0 0 2 3 0 0 0 1 }{ 1 1 1 1 1 2 3 0 0 0 1 }
26{ 1 1 1 1 1 2 3 0 0 0 1 }{ 0 0 0 0 0 2 3 0 0 0 1 }{ 0 0 0 0 0 2 3 0 0 0 1 }{ 0 0 0 0 0 2 3 0 0 0 1 }{ 0 0 0 0 0 2 3 0 0 0 1 }{ 0 0 0 0 0 2 3 0 0 0 1 }{ 0 0 0 0 0 2 3 0 0 0 1 }{ 0 0 0 0 0 2 3 0 0 0 1 }{ 0 0 0 0 0 2 3 0 0 0 1 }{ 0 0 0 0 0 2 3 0 0 0 1 }{ 0 0 0 0 0 2 3 0 0 0 1 }{ 0 0 0 0 0 2 3 0 0 0 1 }{ 0 0 0 0 0 2 3 0 0 0 1 }{ 0 0 0 0 0 2 3 0 0 0 1 }{ 0 0 0 0 0 2 3 0 0 0 1 }{ 0 0 0 0 0 2 3 0 0 0 1 }{ 0 0 0 0 0 2 3 0 0 0 1 }{ 0 0 0 0 0 2 3 0 0 0 1 }{ 0 0 0 0 0 2 3 0 0 0 1 }{ 0 0 0 0 0 2 3 0 0 0 1 }{ 0 0 0 0 0 2 3 0 0 0 1 }{ 0 0 0 0 0 2 3 0 0 0 1 }{ 0 0 0 0 0 2 3 0 0 0 1 }{ 0 0 0 0 0 2 3 0 0 0 1 }{ 0 0 0 0 0 2 3 0 0 0 1 }{ 0 0 0 0 0 2 3 0 0 0 1 }{ 0 0 0 0 0 2 3 0 0 0 1 }{ 0 0 0 0 0 2 3 0 0 0 1 }{ 0 0 0 0 0 2 3 0 0 0 1 }{ 0 0 0 0 0 2 3 0 0 0 1 }{ 0 0 0 0 0 2 3 0 0 0 1 }{ 1 1 1 1 1 2 3 0 0 0 1 }
27{ 1 1 1 1 1 2 3 0 0 0 1 }{ 0 0 0 0 0 2 3 0 0 0 1 }{ 0 0 0 0 0 2 3 0 0 0 1 }{ 0 0 0 0 0 2 3 0 0 0 1 }{ 0 0 0 0 0 2 3 0 0 0 1 }{ 0 0 0 0 0 2 3 0 0 0 1 }{ 0 0 0 0 0 2 3 0 0 0 1 }{ 0 0 0 0 0 2 3 0 0 0 1 }{ 0 0 0 0 0 2 3 0 0 0 1 }{ 0 0 0 0 0 2 3 0 0 0 1 }{ 0 0 0 0 0 2 3 0 0 0 1 }{ 0 0 0 0 0 2 3 0 0 0 1 }{ 0 0 0 0 0 2 3 0 0 0 1 }{ 0 0 0 0 0 2 3 0 0 0 1 }{ 0 0 0 0 0 2 3 0 0 0 1 }{ 0 0 0 0 0 2 3 0 0 0 1 }{ 0 0 0 0 0 2 3 0 0 0 1 }{ 0 0 0 0 0 2 3 0 0 0 1 }{ 0 0 0 0 0 2 3 0 0 0 1 }{ 0 0 0 0 0 2 3 0 0 0 1 }{ 0 0 0 0 0 2 3 0 0 0 1 }{ 0 0 0 0 0 2 3 0 0 0 1 }{ 0 0 0 0 0 2 3 0 0 0 1 }{ 0 0 0 0 0 2 3 0 0 0 1 }{ 0 0 0 0 0 2 3 0 0 0 1 }{ 0 0 0 0 0 2 3 0 0 0 1 }{ 0 0 0 0 0 2 3 0 0 0 1 }{ 0 0 0 0 0 2 3 0 0 0 1 }{ 0 0 0 0 0 2 3 0 0 0 1 }{ 0 0 0 0 0 2 3 0 0 0 1 }{ 0 0 0 0 0 2 3 0 0 0 1 }{ 1 1 1 1 1 2 3 0 0 0 1 }
28{ 1 1 1 1 1 2 3 0 0 0 1 }{ 0 0 0 0 0 2 3 0 0 0 1 }{ 0 0 0 0 0 2 3 0 0 0 1 }{ 0 0 0 0 0 2 3 0 0 0 1 }{ 0 0 0 0 0 2 3 0 0 0 1 }{ 0 0 0 0 0 2 3 0 0 0 1 }{ 0 0 0 0 0 2 3 0 0 0 1 }{ 0 0 0 0 0 2 3 0 0 0 1 }{ 0 0 0 0 0 2 3 0 0 0 1 }{ 0 0 0 0 0 2 3 0 0 0 1 }{ 0 0 0 0 0 2 3 0 0 0 1 }{ 0 0 0 0 0 2 3 0 0 0 1 }{ 0 0 0 0 0 2 3 0 0 0 1 }{ 0 0 0 0 0 2 3 0 0 0 1 }{ 0 0 0 0 0 2 3 0 0 0 1 }{ 0 0 0 0 0 2 3 0 0 0 1 }{ 0 0 0 0 0 2 3 0 0 0 1 }{ 0 0 0 0 0 2 3 0 0 0 1 }{ 0 0 0 0 0 2 3 0 0 0 1 }{ 0 0 0 0 0 2 3 0 0 0 1 }{ 0 0 0 0 0 2 3 0 0 0 1 }{ 0 0 0 0 0 2 3 0 0 0 1 }{ 0 0 0 0 0 2 3 0 0 0 1 }{ 0 0 0 0 0 2 3 0 0 0 1 }{ 0 0 0 0 0 2 3 0 0 0 1 }{ 0 0 0 0 0 2 3 0 0 0 1 }{ 0 0 0 0 0 2 3 0 0 0 1 }{ 0 0 0 0 0 2 3 0 0 0 1 }{ 0 0 0 0 0 2 3 0 0 0 1 }{ 0 0 0 0 0 2 3 0 0 0 1 }{ 0 0 0 0 0 2 3 0 0 0 1 }{ 1 1 1 1 1 2 3 0 0 0 1 }
29{ 1 1 1 1 1 2 3 0 0 0 1 }{ 0 0 0 0 0 2 3 0 0 0 1 }{ 0 0 0 0 0 2 3 0 0 0 1 }{ 0 0 0 0 0 2 3 0 0 0 1 }{ 0 0 0 0 0 2 3 0 0 0 1 }{ 0 0 0 0 0 2 3 0 0 0 1 }{ 0 0 0 0 0 2 3 0 0 0 1 }{ 0 0 0 0 0 2 3 0 0 0 1 }{ 0 0 0 0 0 2 3 0 0 0 1 }{ 0 0 0 0 0 2 3 0 0 0 1 }{ 0 0 0 0 0 2 3 0 0 0 1 }{ 0 0 0 0 0 2 3 0 0 0 1 }{ 0 0 0 0 0 2 3 0 0 0 1 }{ 0 0 0 0 0 2 3 0 0 0 1 }{ 0 0 0 0 0 2 3 0 0 0 1 }{ 0 0 0 0 0 2 3 0 0 0 1 }{ 0 0 0 0 0 2 3 0 0 0 1 }{ 0 0 0 0 0 2 3 0 0 0 1 }{ 0 0 0 0 0 2 3 0 0 0 1 }{ 0 0 0 0 0 2 3 0 0 0 1 }{ 0 0 0 0 0 2 3 0 0 0 1 }{ 0 0 0 0 0 2 3 0 0 0 1 }{ 0 0 0 0 0 2 3 0 0 0 1 }{ 0 0 0 0 0 2 3 0 0 0 1 }{ 0 0 0 0 0 2 3 0 0 0 1 }{ 0 0 0 0 0 2 3 0 0 0 1 }{ 0 0 0 0 0 2 3 0 0 0 1 }{ 0 0 0 0 0 2 3 0 0 0 1 }{ 0 0 0 0 0 2 3 0 0 0 1 }{ 0 0 0 0 0 2 3 0 0 0 1 }{ 0 0 0 0 0 2 3 0 0 0 1 }{ 1 1 1 1 1 2 3 0 0 0 1 }
30{ 1 1 1 1 1 2 3 0 0 0 1 }{ 0 0 0 0 0 2 3 0 0 0 1 }{ 0 0 0 0 0 2 3 0 0 0 1 }{ 0 0 0 0 0 2 3 0 0 0 1 }{ 0 0 0 0 0 2 3 0 0 0 1 }{ 0 0 0 0 0 2 3 0 0 0 1 }{ 0 0 0 0 0 2 3 0 0 0 1 }{ 0 0 0 0 0 2 3 0 0 0 1 }{ 0 0 0 0 0 2 3 0 0 0 1 }{ 0 0 0 0 0 2 3 0 0 0 1 }{ 0 0 0 0 0 2 3 0 0 0 1 }{ 0 0 0 0 0 2 3 0 0 0 1 }{ 0 0 0 0 0 2 3 0 0 0 1 }{ 0 0 0 0 0 2 3 0 0 0 1 }{ 0 0 0 0 0 2 3 0 0 0 1 }{ 0 0 0 0 0 2 3 0 0 0 1 }{ 0 0 0 0 0 2 3 0 0 0 1 }{ 0 0 0 0 0 2 3 0 0 0 1 }{ 0 0 0 0 0 2 3 0 0 0 1 }{ 0 0 0 0 0 2 3 0 0 0 1 }{ 0 0 0 0 0 2 3 0 0 0 1 }{ 0 0 0 0 0 2 3 0 0 0 1 }{ 0 0 0 0 0 2 3 0 0 0 1 }{ 0 0 0 0 0 2 3 0 0 0 1 }{ 0 0 0 0 0 2 3 0 0 0 1 }{ 0 0 0 0 0 2 3 0 0 0 1 }{ 0 0 0 0 0 2 3 0 0 0 1 }{ 0 0 0 0 0 2 3 0 0 0 1 }{ 0 0 0 0 0 2 3 0 0 0 1 }{ 0 0 0 0 0 2 3 0 0 0 1 }{ 0 0 0 0 0 2 3 0 0 0 1 }{ 1 1 1 1 1 2 3 0 0 0 1 }
31{ 1 1 1 1 1 2 3 0 0 0 1 }{ 1 1 1 1 1 2 3 0 0 0 1 }{ 1 1 1 1 1 2 3 0 0 0 1 }{ 1 1 1 1 1 2 3 0 0 0 1 }{ 1 1 1 1 1 2 3 0 0 0 1 }{ 1 1 1 1 1 2 3 0 0 0 1 }{ 1 1 1 1 1 2 3 0 0 0 1 }{ 1 1 1 1 1 2 3 0 0 0 1 }{ 1 1 1 1 1 2 3 0 0 0 1 }{ 1 1 1 1 1 2 3 0 0 0 1 }{ 1 1 1 1 1 2 3 0 0 0 1 }{ 1 1 1 1 1 2 3 0 0 0 1 }{ 1 1 1 1 1 2 3 0 0 0 1 }{ 1 1 1 1 1 2 3 0 0 0 1 }{ 1 1 1 1 1 2 3 0 0 0 1 }{ 1 1 1 1 1 2 3 0 0 0 1 }{ 1 1 1 1 1 2 3 0 0 0 1 }{ 1 1 1 1 1 2 3 0 0 0 1 }{ 1 1 1 1 1 2 3 0 0 0 1 }{ 1 1 1 1 1 2 3 0 0 0 1 }{ 1 1 1 1 1 2 3 0 0 0 1 }{ 1 1 1 1 1 2 3 0 0 0 1 }{ 1 1 1 1 1 2 3 0 0 0 1 }{ 1 1 1 1 1 2 3 0 0 0 1 }{ 1 1 1 1 1 2 3 0 0 0 1 }{ 1 1 1 1 1 2 3 0 0 0 1 }{ 1 1 1 1 1 2 3 0 0 0 1 }{ 1 1 1 1 1 2 3 0 0 0 1 }{ 1 1 1 1 1 2 3 0 0 0 1 }{ 1 1 1 1 1 2 3 0 0 0 1 }{ 1 1 1 1 1 2 3 0 0 0 1 }{ 1 1 1 1 1 2 3 0 0 0 1 }

textures:
0 images/white.png 
1 images/redbrick.png 
2 images/grid.jpg 
3 images/wood.bmp 
4 images/water.bmp 
5 images/water2.bmp 
6 images/water3.bmp 
7 images/water4.bmp 
8 images/grass.jpg 
10 images/receptenboekje.jpg 
11 images/greystone.png 
12 images/latje.jpg 
13 images/grid.jpg 
14 images/landscape.jpg 
15 images/moon.jpg 
16 images/bunny.jpg 
17 images/space.bmp 
18 images/evilT.jpg 
19 images/bluestone.png 
20 images/gras.bmp 
21 images/pc.jpg 
22 images/dBarrel.png 
23 images/dLamp.png 
24 images/dPillar.png 
26 images/iron.jpg 
27 images/moon.jpg 
28 images/ceilingCat.jpg 
-1
#